内容,时间,点赞,转发,评论,赞转评合计,文本长度,作者
我们的社会已经开始面临严重问题，严重到忠诚、守信、孝悌、守规矩的孩子，90%到社会上会吃亏。钱文忠  ,2024/1/20 8:01,2763,237,46,3046,51,钱文忠
“最高贵的惩罚是沉默，最矜持的报复是无视。” 杨绛  ,2024/1/20 0:50,1153,177,16,1346,27,杨绛
爱情来了不要害怕，好好享受，因为它会逝去；爱情走了不要害怕，因为天下乌鸦在，男人就在；事业失败了不要害怕，因为还有新的机会，而人生是注定失败的；一无所有不要害怕，因为人都是从一无所有开始的。反正怎么都不要害怕，大不了重新再来。余秀华《无端欢喜》  ,2024/1/19 19:08,671,126,11,808,124,余秀华
要自杀的人，也会怕大海的汪洋，怕夏天死尸的易烂。但遇到澄静的清池，凉爽的秋夜，他往往也自杀了。鲁迅《小杂感》  ,2024/1/19 17:38,4349,522,34,4905,56,鲁迅
“生命是用来享受的，不是用来熬日子的。”李银河  ,2024/1/19 14:39,2105,366,28,2499,25,李银河
无论在何种困顿中，唯有内心的自由馈赠我们真正的未来。陈春成《夜晚的潜水艇》  ,2024/1/19 10:14,699,92,12,803,39,陈春成
人真的好奇怪，只有在快要死的时候，才会思考起怎么活。陆春吾《一生悬命》  ,2024/1/18 16:01,817,110,9,936,37,陆春吾
我对他说，走过去吧，那里树叶会向你招手，石头会向你微笑，河水会向你问候。那里没有贫贱也没有富贵，没有悲伤也没有疼痛，没有仇也没有恨……那里人人死而平等。他问：“那是什么地方？”我说：“死无葬身之地。”余华  ,2024/1/18 11:36,729,168,19,916,104,余华
爱不在任何结局，能爱而去爱或不能爱而不去爱这种过程，才是终极的意义。邱妙津《鳄鱼手记》  ,2024/1/18 9:33,2024,358,19,2401,45,邱妙津
如果你不诚实面对自己的感觉，自己所需要的，那么你永远无法诚实地爱别人。邱妙津《鳄鱼手记》  ,2024/1/17 17:17,2349,441,19,2809,46,邱妙津
他的话，他的誓言，他的真挚，在灯光、烛光和美酒佳肴的五彩缤纷中闪耀着光芒，更在他自己眼睛里闪烁着光芒。这光芒是美丽的、真纯的、毋庸置疑的。可是如果把它放在漫长的时间里，放在曲折复杂、充满尘污、难以预知的生活现实里，还能永葆这样的明洁与清纯吗？ 冯骥才 《多瑙河峡谷》  ,2024/1/17 10:34,483,93,6,582,135,冯骥才
但是太阳，他每时每刻都是夕阳也都是旭日。当他熄灭着走下山去收尽苍凉残照之际，正是他在另一面燃烧着爬上山巅布散烈烈朝辉之时。史铁生  ,2024/1/17 7:45,1605,188,7,1800,66,史铁生
“为什么还要给一个不值得你爱的人写信？”“或许跟这个人无关，是为了我自己的爱”邱妙津《蒙马特遗书》  ,2024/1/17 2:31,2798,351,27,3176,51,邱妙津
“这个世界，对于心态好的人，是开心肆意的天堂，只要你有想法，想怎么玩怎么玩。对于怯懦者，那就是地狱，你会觉得世界在与你为敌。你眼中的世界是什么样子，取决于你是一个什么样的人。”冯唐  ,2024/1/16 17:21,492,97,5,594,92,冯唐
告诉我。光是要去爱的动能、纯洁、忍耐和决心，够不够？够不够？邱妙津《鳄鱼手记》  ,2024/1/16 13:16,682,84,5,771,41,邱妙津
生活是由许许多多不如意的细节构成的，完美主义者都是心力交瘁的苦命人。木心  ,2024/1/16 10:18,1333,232,19,1584,38,木心 
但是二十岁上下的人，不谈恋爱尚且可做到，不向往爱情则不可能，除非心理有毛病。史铁生《我与地坛》  ,2024/1/16 8:18,5691,296,151,6138,49,史铁生
人不可以逃避苦难，亦不可以放弃希望。命运并不受贿，但希望与你同在，这才是信仰的真意，是信者的路。史铁生《病隙碎笔》  ,2024/1/15 22:28,1366,206,4,1576,59,史铁生
浪漫，就是浪费时间慢慢吃饭，浪费时间慢慢喝茶，浪费时间慢慢走，浪费时间慢慢变老。林清玄《人间有味是清欢》  ,2024/1/15 16:23,930,116,16,1062,54,林清玄
“一次又一次觉得，灵智比肉欲要性感得多。”木心《云雀叫了一整天》  ,2024/1/15 13:10,1683,204,33,1920,34,木心
我的人生理想有三：1.不工作；2.没人管；3.单身汉。木心  ,2024/1/15 9:40,5795,657,106,6558,31,木心
人最大的悲哀是失去曾经有过最大渴望的欲望。邱妙津《鳄鱼手记》  ,2024/1/15 7:55,1854,258,16,2128,32,邱妙津
无论谁再要对我讲一句重话，我就发疯了。白先勇《寂寞的十七岁》  ,2024/1/14 20:29,4015,905,58,4978,32,白先勇
死是一件不必急于求成的事，死是一个必然会降临的节日。史铁生《我与地坛》  ,2024/1/14 16:56,2503,235,19,2757,37,史铁生
“天下只有两种人。譬如一串葡萄到手，一种人挑最好的吃，另一种人把最好吃的留在最后吃。照例第一种人应该乐观，因为他每吃一颗都是吃剩的葡萄里最好的；第二种人应该悲观，因为他每吃一颗都是吃剩的葡萄里最坏的。不过事实上适得其反，缘故是第二种人还有希望，第一种人只有回忆。”钱钟书《围城》  ,2024/1/14 14:57,672,117,27,816,141,钱钟书
在不了解的状况下喜欢上一个人，却发现那个人真实的一面比你想象的还要美好，这应该算的上幸运。八月长安 《橘生淮南・暗恋》  ,2024/1/14 12:18,7450,533,127,8110,61,八月长安
我把石头还给石头让胜利的胜利今夜青稞只属于她自己一切都在生长今夜我只有美丽的戈壁 空空姐姐，今夜我不关心人类，我只想你。海子《日记》  ,2024/1/14 11:44,1545,352,26,1923,68,海子
万事万物，你若预测它的未来你就会说它有无数种可能，可你若回过头去看它的以往你就会知道其实只有一条命定之路。 史铁生《一种谜语的几种简单的猜法》  ,2024/1/13 23:46,1180,358,6,1544,73,史铁生
“我想，大话不宜讲得太早，否则，倘有记性，将来想到时会脸红。”鲁迅《导师》  ,2024/1/13 20:25,1110,109,12,1231,39,鲁迅
你洗了一个澡，你觉得很美好。你看到一朵花的盛开，你觉得很美好。你吃了一顿饭，你觉得很美好。你看到并非全因为澡洗得干净，花开得好，或者菜合你口味。而是你心无挂碍。美好的是生活吗？并不，美好的自始至终都是你自己。钱钟书  ,2024/1/13 16:48,4906,833,70,5809,109,钱钟书
我没带渔具没带沉重的疑虑和枪我带心去了我想，到空旷的海上只要说：爱你鱼群就会跟着我游向陆地。顾城《分别的海》  ,2024/1/13 13:21,581,99,7,687,56,顾城
我至今仍顽固的认为，乡下的女人，在25岁以前，她们是美好的；25岁到55岁之间，则集中了世上所有毛病一起爆发；而55岁以后，善良和慈祥又恢复上身，成了菩萨。贾平凹《我是农民》  ,2024/1/13 10:30,6275,272,137,6684,89,贾平凹
贪安稳就没有自由，要自由就总要历些危险。只有这两条路。鲁迅   二月十九日在香港青年会讲演  ,2024/1/12 11:26,1952,374,20,2346,47,鲁迅
事实上，有些崇高是人所共知的虚伪，这种东西比堕落还要坏。 王小波 《一只特立独行的猪》  ,2024/1/11 21:06,828,105,9,942,45, 王小波
“心野掉了就念不进书，就没心思干活，就只适合日复一日地坐在野地里发呆，在黄昏和夜晚的缝隙中一次又一次地消融。你就很难再回到真实的人世间，捡起上进心，努力去做一个世俗的成功者了。因为你已经知道了，在山野中，在天一点一点黑下来的时刻，一切都无关紧要。知道了就没法再不知道。”陈春成《夜晚的潜水艇》,2024/1/11 15:01,3810,1108,49,4967,146,陈春成
命运不是风来回吹，命运是大地，走到哪里你都在命中。顾城《断章》  ,2024/1/11 12:28,2179,279,16,2474,33,顾城
一个人要兴旺发达，得有一点精气神。汪曾祺  ,2024/1/11 8:01,2691,297,13,3001,22,汪曾祺 
明智的放弃，胜过盲目的执着。林语堂  ,2024/1/11 1:17,1697,259,20,1976,19,林语堂
我们两个人都病入膏肓了，像两颗荆棘互相拥抱，你渴望收容我，我也渴望被你收容，但我们各拔不掉自身上的荆棘，我们相克。邱妙津  ,2024/1/10 20:00,2016,352,29,2397,62,邱妙津
能改变自己的都是神，想改变他人的都是神经病。莫言  ,2024/1/10 17:20,15338,1992,151,17481,26,莫言  
在我看来，有些人已经疯了，有些人正在一点点死掉。按照别人要求的那样思考，谈论所有当下流行的话题，很快便掌握了网上新造的词汇，卖弄自己并不牢固的幸福，自以为是地与人辩论，虚张声势的愤怒，发自内心的卑微，一边吵闹着这是一个多么荒谬的世界，一边为这个荒谬的世界添砖加瓦，让它变得一天比一天荒谬。双雪涛《聋哑时代》,2024/1/10 15:41,1428,488,31,1947,153,双雪涛
“你这个爱情故事，好像是个悲剧”“你说的是婚姻，爱情没有悲剧”史铁生《我与地坛》  ,2024/1/10 11:29,2740,246,31,3017,42,史铁生
好好挑朋友，好好挑伙伴，好好挑对象，好好挑和你有关的人，人也有伪劣产品。朱德庸  ,2024/1/10 8:03,2034,246,18,2298,41,朱德庸
“我该如何爱你？风吹动岁月的经幡，近也不能，远也不能。” 余秀华《月光落在左手上》  ,2024/1/9 22:20,2855,383,20,3258,43,余秀华
“在一起时恩恩义义，分开时潇潇洒洒。”汪曾祺《八千岁》  ,2024/1/9 16:49,2352,272,11,2635,29,汪曾祺
中国人从不爱中国人，但却很爱国。爱人是需要投入情感，付出时间精力、经济成本的，爱国只需付出口水。胡适  ,2024/1/9 12:55,48030,2309,1630,51969,52,胡适
且视他人之疑目如盏盏鬼火，大胆地去走你的夜路。史铁生《病隙碎笔》  ,2024/1/9 11:05,2407,287,19,2713,34,史铁生
我爱你的方式，一直都是任自己被你打败。邱妙津《蒙马特遗书》  ,2024/1/9 8:03,1777,290,18,2085,31,邱妙津
所有伤害你的人，都是故意的，他在伤害你的时候就已权衡利弊，他会不断的对比，最后选择了伤害你。莫言  ,2024/1/8 22:32,3886,719,54,4659,50,莫言
“那路途中的一切，有些与我擦肩而过从此天各一方，有些便永久驻进我的心魂，雕琢我，塑造我，锤炼我，融入我而成为我。”史铁生《病隙碎笔》  ,2024/1/8 16:51,3963,546,14,4523,68,史铁生
爱就像语言，闻者不闻，言者还是哑巴。史铁生  《病隙碎笔》  ,2024/1/8 14:34,2340,224,7,2571,31,史铁生
差不多每年的十二月下旬到一月中旬总会是冬天里最难熬的日子，无可躲避。再往后，随着白昼的变长，气温总会渐渐缓过来。一切总会过去的。是的，“一切总会过去”。人之所以能够感到“幸福”，不是因为生活得舒适，而是因为生活得有希望。李娟  ,2024/1/8 7:39,915,238,12,1165,114,李娟
我也有过欲望的盛年有过身心俱裂的许多夜晚但是我从未放逐过自己                                         余秀华《给你》  ,2024/1/7 23:01,1289,136,14,1439,80,余秀华
人生三个基本目标：不作恶，开心，自己养活自己。如果能达到，就是很好的一生了。冯唐  ,2024/1/7 10:54,2219,321,31,2571,42,冯唐
愿中国青年都摆脱冷气，只是向上走，不必听自暴自弃者流的话。能做事的做事，能发声的发声。有一分热，发一分光，就令萤火般，也可以在黑暗里发一点光，不必等候炬火。鲁迅《热风》  ,2024/1/7 10:14,830,121,16,967,86,鲁迅
“情种只生在大富之家。”老舍《骆驼祥子》  ,2024/1/7 8:15,5473,318,86,5877,22,老舍
“重要的是，有一个健康的身体、一颗感知清风明月的心和跟人说话时不会躲闪的眼神。”韩梅梅《今天的我有点热爱生活》  ,2024/1/7 0:34,3183,459,25,3667,57,韩梅梅
何必这样的奔逃呢，前路也是在下着雨。施蛰存《梅雨之夕》  ,2024/1/6 19:55,4163,913,39,5115,29,施蛰存
语言达不到的地方，就是爱情的栖息之地。所有说得出来的爱，都是表面的。一个人心里犹犹豫豫，脚步却狂奔过去的人，那就是真爱了。梁永安  ,2024/1/6 17:34,1535,265,10,1810,66,梁永安
汪小姐说，有一种女人，开口就谈情调，谈巴黎，谈吃茶，谈人生，这是十三点。开口闭口谈小囡，奶瓶，尿布，打预防针，标准十三点。一开口，就是老公长，老公短，这是妖怪。 金宇澄《繁花》  ,2024/1/6 16:24,1594,190,64,1848,90,金宇澄
每个人的童年都有一个严肃的结尾，大约都是突然面对了一个严峻的事实，再不能睡一宿觉就把它忘掉，事后你发现，童年不复存在了。史铁生  ,2024/1/6 10:22,2831,354,23,3208,65,史铁生
你挺悲观的，但是不彻底，所以才拧巴。   冯唐《万物生长》  ,2024/1/6 0:27,9597,1392,82,11071,31,冯唐
真正的爱情不应该是利己的，而应该是利他的。你有没有决心为Ta而作出自己的最大牺牲，这是衡量是不是真正爱情的标准，否则就是被自己的感情所欺骗。路遥《平凡的世界》  ,2024/1/5 20:45,602,93,35,730,81,路遥
我对生活只有恨，没有爱，爱被我恨死了。麦家《人生海海》  ,2024/1/5 11:35,5369,896,46,6311,29,麦家
他说的让她三分不是“三分流水七分尘”的“三分”是“天下只有三分月”的“三分”。 钱钟书《围城》  ,2024/1/5 8:00,1694,229,20,1943,49,钱钟书
因而我盼望夜晚，盼望黑夜，盼望寂静中自由的到来。甚至盼望站到死中，去看生。史铁生  ,2024/1/4 22:06,2287,312,16,2615,42,史铁生
你走了以后我每天都感到很闷，就像堂吉诃德一样，每天想念托波索的达辛尼亚。王小波《爱你就像爱生命》  ,2024/1/4 17:20,1004,102,4,1110,50,王小波
谁见过人蓄养凤凰？谁又能束缚月光呢？沈从文《月下小景》  ,2024/1/4 13:12,2151,346,34,2531,29,沈从文
“一切都在无可挽回的走向庸俗” 王小波  ,2024/1/4 3:05,2101,273,27,2401,21,王小波
爱是根本的希望，爱，这才需要诉说史铁生《我与地坛》  ,2024/1/3 23:44,3904,293,7,4204,27,史铁生
仔仔细细把头发和脸洗一洗，你会对人生有了好的想法。木心  ,2024/1/3 22:16,1707,230,25,1962,29,木心
我的火焰，在十六岁那年就熄灭了，我余生成就的所谓事业，不过是火焰熄灭后升起的几缕青烟罢了。陈春成《夜晚的潜水艇》  ,2024/1/3 13:32,3348,413,51,3812,58,陈春成
你绝对温存，绝对可爱，生机勃勃，全无畏惧而且自信。我从你身上感到一种永存的精神，超过平庸生活里的一切。王小波 《地久天长》  ,2024/1/3 11:42,2317,402,11,2730,63,王小波
这世界上最好的的关系是两个人相互理解，其次是两个人相互不理解，最差的关系是一个理解一个不理解。这也是那么多人喋喋不休说了一通之后，对方会说“哦”的原因。 刘同《向着光亮那方》  ,2024/1/3 8:36,1007,145,19,1171,89,刘同
每想你一次，天上飘落一粒沙，从此形成了撒哈拉；每想你一次，天上就掉下一滴水，于是形成了太平洋。   三毛《撒哈拉沙漠》  ,2024/1/3 0:00,685,78,17,780,61, 三毛
人与人的交往多半肤浅。或者说，只有在比较肤浅的层面上，交往是容易的。一旦走向复杂，人与人就是相互的迷宫。史铁生  ,2024/1/2 16:22,2153,381,24,2558,57,史铁生
她不明白。不明白她会爱上我，或她正在爱着我。不明白我温驯羊毛后面是只饥饿的狂兽，抑制将她撕碎的冲动。不明白一切的一切都是爱的交易。不明白她使我受苦。不明白有爱这种东西。她送给我一盒拼图。耐心地一块一块把我拼出来。 邱妙津《鳄鱼笔记》  ,2024/1/2 10:08,703,112,7,822,118,邱妙津
祝你今天愉快。你明天的愉快留着我明天再祝。王小波《爱你就像爱生命》  ,2024/1/2 8:17,2612,235,23,2870,35,王小波
她之所以接受我，是因没有拒绝。而不是爱。邱妙津《鳄鱼手记》  ,2024/1/1 21:38,2086,222,18,2326,31,邱妙津
每一次告别，最好用力一点。多说一句，可能是最后一句。多看一眼，可能是最后一眼。韩寒《后会无期》  ,2024/1/1 15:23,1574,270,23,1867,49,韩寒
不改山河旧，同瞻日月新。贝琼《巳酉元旦》  ,2024/1/1 12:48,1156,136,4,1296,22,贝琼
其实我一直觉得所谓爱，就是陪伴，没太多别的。韩寒  ,2024/1/1 8:00,9705,842,110,10657,26,韩寒 
但愿在新的一年里，我们能远离一切古怪的事，大家都能做个健全的人—我实在想不出有什么话比这句话更吉利。王小波  ,2023/12/31 23:35,10867,2077,78,13022,55,王小波
是的，“一切总会过去”。人之所以能够感到“幸福”，不是因为生活得舒适，而是因为生活的有希望。李娟《冬牧场》  ,2023/12/31 18:30,1342,150,17,1509,55,李娟
“多少年后，我醒悟过来，终于发现了一个宇宙真理：在公有制体系里，每个单位都是小人的天下；正直的人总是少数，且无权势；群众的眼晴都是瞎的、势利的，他们大部分情况下不会站在君子一边。坏人是不会改好的，因为他不认为自己是坏人。”季羡林  ,2023/12/31 12:43,889,140,15,1044,116,季羡林
我爱我身体里块块锈斑胜过爱你余秀华《我想要的爱情 》  ,2023/12/31 8:30,2139,169,15,2323,28,余秀华
我经常有那种感觉，如果这个事情来了，你却没有勇敢地去解决掉，它一定会再来。生活真是这样，它会一次次地让你去做这个功课直到你学会为止。廖一梅《像我这样笨拙地生活》  ,2023/12/30 23:14,2399,456,15,2870,82,廖一梅
我只想逃脱这样的生活和深爱之人在雪地上不停地滚下去直到雪崩把我们掩埋余秀华《下雪了 》  ,2023/12/30 19:44,1962,391,20,2373,45,余秀华
大约生命的事情就是这样的吧：终究各归其途，只要安心就好。李娟《冬牧场》  ,2023/12/30 18:56,946,132,4,1082,37,李娟
我有点疲倦了，但我总还要有勇气在狗一样的生活上，做出神仙一样的事。汪曾祺  ,2023/12/30 14:02,2134,420,18,2572,38,汪曾祺
大学，这个制度是好的。比死亡制度差点，占第二名。它刚好在社会三大制度（强迫教育，强迫工作和强迫结婚）重叠交接的点上，这三大制度是人类最伟大的发明，三重伟大加乘在一起，反而得以暂时自沉重的伟大性中逃脱。它和死亡都是种类似安全门的逃脱制度，它占第二名的原因是，死亡通到的是太平间，大学却从单绳制度通到天罗地网的社会。并且，死亡是人人平等，大学则从某些人身上刮取不仁道的膏脂，仁道地涂在另一些人身上。邱妙津 ​​​《鳄鱼手记》,2023/12/30 9:02,1825,526,22,2373,210,邱妙津
我已不在地坛，地坛在我。 史铁生《我与地坛》  ,2023/12/29 20:08,2404,162,9,2575,24,史铁生
中国人，得意时信儒，失意时信道，绝望时信佛，信仰随时可变，本质就是没有信仰。林语堂  ,2023/12/29 15:50,9511,1175,233,10919,43,林语堂
这个人也许永远也不回来了，也许明天就回来。沈从文 《边城》  ,2023/12/29 14:14,2755,366,35,3156,31,沈从文
“我要有做我自己的自由，和敢做我自己的胆量”林语堂《我的愿望》  ,2023/12/29 8:21,2471,375,7,2853,33,林语堂
常以为人是一个容器，盛着快乐，盛着悲哀。但人不是容器，人是导管，快乐流过，悲哀流过，导管只是导管。各种快乐悲哀流过流过，一直到死，导管才空了。疯子，就是导管的淤塞和破裂。木心《哥伦比亚的倒影》  ,2023/12/28 23:11,1626,362,6,1994,98,木心
不管你对多少个男人失望了，你都没有理由对爱情失望。因为爱情本身就是希望，永远是生命的一种希望。爱情是你自己的品质，是你自己的心魂，是你自己的处境，与别人无关。爱情不是一个名词，而是动词，永远的动词，无穷动。史铁生《务虚笔记》  ,2023/12/28 18:08,1886,330,45,2261,114,史铁生
眼泪决不能洗掉命运。鲁迅《故事新编》  ,2023/12/28 16:33,2924,341,22,3287,20,鲁迅
击鼓之后，我们把在黑暗中跳舞的心脏叫做月亮。这月亮主要由你构成。 海子《亚洲铜》  ,2023/12/28 13:47,2019,263,10,2292,42,海子
“当我痛苦地站在你的面前你不能说我一无所有你不能说我两手空空”海子《答复》  ,2023/12/28 8:32,3789,389,26,4204,39,海子
“不爱而被爱，和爱而不被爱，我宁愿要后者。” “就没有爱而且被爱的吗？” “那可不是人人都能碰上的福气。” 史铁生《务虚笔记》  ,2023/12/27 21:43,3059,383,56,3498,65,史铁生
缺憾有时比圆满更美，真是不可思议。林清玄《受苦真好 》  ,2023/12/27 19:37,1535,210,18,1763,29,林清玄
无论如何，寒冷的日子总是意味着寒冷的“正在过去”。李娟  ,2023/12/27 16:54,1515,187,14,1716,29,林清玄
人是被时间磨损的吗？不是的。人是被各种各样的离别磨损的。李娟  ,2023/12/27 12:37,4568,631,45,5244,32,李娟
我一直在走各种极端，一直在裁判自己。在我生命里总有锋利的剑，有变幻的长披风，有黑鸽子和圣女崇拜；我生怕学会宽恕自己。顾城《顾城哲思录》  ,2023/12/27 8:05,1487,253,7,1747,69,顾城
我希望我的“自我”永远滋滋作响，翻腾不休，就像火炭上的一滴糖。王小波《爱你就像爱生命》  ,2023/12/26 22:31,2863,490,13,3366,45,王小波
人生在世，会遇到一些好事，还会遇上些坏事。好事我承受得起，坏事也承受得住。就这样坦荡荡做个寻常人也不坏。王小波  ,2023/12/26 20:15,736,91,8,835,57,王小波
“你千万别糊涂，死人都还想活过来，你一个大活人可不能去死。”  余华《活着》  ,2023/12/26 17:30,3354,234,38,3626,40,余华
爱情是什么？爱就是碰上了，然后爱上了，然后一点办法也没有。王小波  ,2023/12/26 8:26,2214,256,37,2507,34,王小波
世上如果还有真要活下去的人们，就先该敢说，敢笑，敢哭，敢怒，敢骂，敢打，在这可诅咒的地方击退了可诅咒的时代！鲁迅《忽然想到》  ,2023/12/25 16:33,863,155,6,1024,64,鲁迅
照我看来凡是能在这个无休无止的烦恼、仇恨、互相监视的尘世之上感到片刻欢欣的人，都可以算是个诗人。王小波  ,2023/12/25 12:30,928,164,6,1098,53,王小波
“这个世界上也有人不了解海，不知爱海。也有人了解海，不敢爱海。”沈从文《八骏图》  ,2023/12/25 8:00,1924,237,28,2189,42,沈从文
冬天伴着火炉和书，一遍遍坚定不死的决心，写一些并不发出的信。史铁生  ,2023/12/24 18:58,2472,356,6,2834,35,史铁生
她之所以接受我，是因没有拒绝。而不是爱。邱妙津《鳄鱼手记》  ,2023/12/24 14:21,3992,352,19,4363,31,邱妙津
"我是一个任性的孩子
我想涂去一切不幸
我想在大地
画满窗子
让所有习惯黑暗的眼睛
都习惯光明
我想画下风
画下一架比一架更高大的山岭
画下东方民族的渴望
画下大海——
无边无际愉快的声音
……

我在希望
在想
但不知道为什么
我没有领到蜡笔
没有得到一个彩色的时刻
我只有我
我的手指和创痛
只有撕碎那一张张
心爱的白纸
让它们去寻找蝴蝶
让它们从今天消失

我是一个孩子
一个被幻想妈妈宠坏的孩子
我任性

顾城《我是一个任性的孩子》",2023/12/24 9:06,463,70,2,535,219,顾城
时间不早了可我一刻也不想离开你，一刻也不想离开你可时间毕竟是不早了。   史铁生《我与地坛》  ,2023/12/24 3:19,4403,592,34,5029,48,史铁生
我有点疲倦了，但我总还要有勇气在狗一样的生活上，做出神仙一样的事。汪曾祺  ,2023/12/23 23:12,2101,466,29,2596,38,汪曾祺
我想念她。罪有应得。邱妙津《鳄鱼手记》  ,2023/12/23 15:34,2255,434,33,2722,21,邱妙津
我喜欢你，有分寸的、节制的、狂喜的、哭泣的。三毛《我喜欢你》  ,2023/12/23 13:28,2313,280,12,2605,32,三毛
你记住，喜欢是暂时的，没用。钱，学业，前途，才是永远的。冯唐《北京，北京》  ,2023/12/23 8:36,41468,3669,807,45944,39,冯唐
有些事情一直忘不掉，写出来也许会好过些。如果还不行，就再写一次。再一次。就像做梦一样，有的梦会重复做。黄锦树《雨》  ,2023/12/22 20:10,1551,288,14,1853,59,黄锦树
在这一天以后所有的光阴里，你逃得开某种意义，但逃不开意义，如同你逃得开一次旅行但逃不开生命之旅。史铁生《我与地坛》  ,2023/12/22 15:20,1601,215,6,1822,59,史铁生
"""我曾走过山，走过水，其实只是借助它们走过我的生命""史铁生《病隙碎笔》  ",2023/12/22 10:05,7431,605,27,8063,37,史铁生
人的故乡，并不止于一块特定的土地，而是一种辽阔无比的心情，不受空间和时间的限制；这心情一经唤起，就是你已经回到了故乡。史铁生《我与地坛》  ,2023/12/22 0:03,1335,177,18,1530,70,史铁生
我爱你的方式，一直都是任自己被你打败。邱妙津《蒙马特遗书》  ,2023/12/21 19:01,2588,517,28,3133,31,邱妙津
你不愿意种花你说：“我不愿看见它一点点凋落”是的为了避免结束你避免了一切开始顾城 《避免》  ,2023/12/21 17:26,1342,236,30,1608,47,顾城
"""生活是属于每个人自己的感受，不属于任何别人的看法。""余华  ",2023/12/21 11:13,1547,214,8,1769,31,余华
“进退维谷之日正可能是别有洞天之时，这差不多能算规律。”史铁生《病隙碎笔》  ,2023/12/21 8:00,2080,312,19,2411,39,史铁生
他开始感觉人生的悲哀，他想一个人来到世间，只是悲角登场，捧心，皱眉，哀啼，甚而至于泣血，到末了深黑的幕落下，什么事情都完了。不要登场吧，自己实在做不得主，因为父母早已把你送到剧场的后台。上去演一出喜剧吧，那舞台就不是演喜剧的舞台，你要高兴，你要欢笑，无非加深你的失望和寂寞。他想自己是到了登场的时刻了，装扮好了，怀着怯弱的怨抑的心情踅上去，怎知道等在场上的是一个青面獠牙的魔鬼，还是一条口中喷火的毒龙？魔鬼也罢，毒龙也罢，自己要演悲剧是注定的了。叶圣陶《倪焕之》,2023/12/20 16:33,356,85,4,445,231,叶圣陶
不妨勇敢地活下去，不必求熟习世故哲学，不必八面玲珑来取得成功，毫无顾忌地接受挫折，不用作得失考虑，也不必作无效果的自救。沈从文  ,2023/12/20 11:19,932,178,17,1127,65,沈从文 
你是甜的，但是不能中和我身上苦的味道。你说出爱，也无法打消我对人世的怀疑。余秀华  ,2023/12/20 8:16,2229,289,10,2528,42,余秀华
当我沉默的时候我觉得很充实，当我开口说话就感到了空虚。鲁迅《野草》  ,2023/12/19 20:31,1346,210,8,1564,35,鲁迅
人的身体就是悲伤。它由凹陷的地方、柔软的地方、容易受伤的地方填满。手臂、腋下、胸部、大腿间。这具身体为了拥抱人，为了被别人拥抱而诞生。韩江《失语者 》  ,2023/12/19 18:41,1423,298,12,1733,77,韩江
我失去过很多朋友，但从不觉得可惜。既然渐渐发现了分歧，有了争吵，有了误解，再交往也是无益。更重要的是，缘分尽了，他们加于我的力量渐渐弱了。他们抓不住我了，便被我抛弃。     李娟《记一忘三二》  ,2023/12/19 12:28,5316,821,71,6208,99,李娟
人生轨迹中有无数擦肩而过的陌路人，偶尔我们幸运地跟另一条轨迹志同道合一段，也许是半辈子，也许是半天，也许是半小时，都是礼物，值得珍惜。陈冲  ,2023/12/19 8:08,647,100,4,751,71,陈冲
人和人如果不在一个层次上， 那么无论你做什么， 对方都觉得不对， 所谓层次，不是社会地位， 而是人品和认知事物的清晰程度。杨绛  ,2023/12/18 21:32,2125,309,13,2447,65,杨绛
生命的意义不在于向外的寻取，而在向内的建立。 史铁生《病隙碎笔》  ,2023/12/18 20:14,2150,265,16,2431,34,史铁生
经过许多个冬天之后，我才渐渐明白自己再躲不过雪，无论我残缩在屋子里，还是远在冬天的另一个地方，纷纷扬扬的雪，都会落在我正经历的一段岁月里。当一个人的岁月像荒野一样敞开时，他便再无法照管好自己。刘亮程《一个人的村庄》  ,2023/12/18 16:12,1301,258,11,1570,109,刘亮程
我们都需要承认，时间的流逝总会带走一些美感。胡辛束《我想要两颗西柚》  ,2023/12/18 12:29,626,54,11,691,36,胡辛束
你被劈开的疼痛在大地弥漫你所说的曙光究竟是什么意思 海子《春天，十个海子》  ,2023/12/18 10:48,2610,460,28,3098,39,海子
你眼睛的面积一定小于湖 你也很少哭 为什么坐在你面前 就像站在湖边 细细的雾水就扯地连天冯唐《水》  ,2023/12/17 18:41,9440,1562,87,11089,51,冯唐
祥子年轻、身体棒，肯下力气拉车，于是吃喝女色都不上心。他觉得只要努力拉车，就一定能买一辆自己的黄包车…老舍《骆驼祥子》  ,2023/12/17 13:33,1628,169,29,1826,61,老舍
逆来顺受，你说我的生命可惜，我自己却不在乎。你看着很危险，我却自己以为得意。不得意怎么样？人生是苦多乐少。萧红《呼兰河传》  ,2023/12/17 10:31,767,132,7,906,63,萧红
“那我就一直游，一直游到海水变蓝”余华  ,2023/12/16 22:54,7673,584,72,8329,21,余华
有一颗心，很骄傲，骄傲的眼眸，素笔难描。一望是水，二望是雪飘。汪国真  ,2023/12/16 14:15,926,155,5,1086,36,汪国真
还是那句话：不要给任何人冠上职业和才华滤镜，人品和这些都是两回事儿，他是一个不错的作家不代表他是一个不错的人。否则历史上的胡适、徐志摩也不会备受争议，还有诸如此类比比皆是。余秀华  ,2023/12/16 8:18,1431,195,14,1640,91,余秀华 
世界摇摇晃晃我忽明忽暗若不是你盛开在那里我刚来到世上就随风而逝李娟  ,2023/12/15 18:39,876,114,5,995,35,李娟
一岁将尽，便进入一种此间特有的情氛中。 冯骥才《时光》  ,2023/12/15 13:08,791,123,5,919,29,冯骥才
人过的日子必是一日遇佛，一日遇魔。贾平凹  ,2023/12/15 8:26,1528,186,16,1730,22,贾平凹
但在我，那天却下着1956年的雪，我不得不用1956年的雪去理解1951年的雪，从而1951年的冬天有了形象，不再是空白。史铁生《务虚笔记》  ,2023/12/14 17:44,2340,286,15,2641,72,史铁生
眼泪决不能洗掉命运。鲁迅《故事新编》  ,2023/12/14 11:26,2575,332,13,2920,20,鲁迅
爱不爱说话，原来也看跟谁在一起。刘震云  ,2023/12/14 11:20,2501,249,48,2798,21,刘震云
“但是，虽说太敏感的人会受苦，我却情愿受这敏感的苦，也不愿成为另外情形的人”李娟《冬牧场》  ,2023/12/14 8:39,2487,339,47,2873,47,李娟
“吃苦必须有收益，牺牲必须有代价。有些人认为，人必须吃一些无意义的苦、虚掷一些年华，用这种方法来达到崇高。这种想法不仅有害，而且是有病的。” 王小波《沉默的大多数》  ,2023/12/13 19:55,815,156,13,984,84,王小波
在无边的旷野上，在凛冽的天宇下，闪闪地旋转升腾着的是雨的精魂…… 是的，那是孤独的雪，是死掉的雨，是雨的精魂。鲁迅《野草》  ,2023/12/13 17:05,872,122,6,1000,63,鲁迅
我是一个在黑暗中大雪纷飞的人呐。 木心《云雀叫了一整天》  ,2023/12/13 13:12,1111,123,8,1242,30,木心
好朋友是怎样个好法的呢 两个晦气沉沉的人 突然见了面 一切都变得光鲜灿烂的样子。木心《木心遗稿》  ,2023/12/13 8:25,8806,1283,474,10563,50,木心
过去的事情，应该深深埋葬起来。我们只应该看现在，想将来。巴金《家》  ,2023/12/12 21:07,1035,135,9,1179,35,巴金
一眨眼，算不算少年。一辈子，算不算永远。余光中  ,2023/12/12 17:32,1366,248,13,1627,25,余光中
“一个太过文艺的人，注定不会太快乐，心里有爱、有善良，骨子里住着孩子般的纯真，但也往往多愁善感，容易感知美好，也更容易体会悲伤。她喜欢文字，却往往不善言辞，不是文字太少，而是感受很多。”三毛  ,2023/12/12 11:04,2019,358,27,2404,97,三毛
“天真的人，不代表没有见过世界的黑暗，恰恰因为见到过，才知道天真的好。”三毛  ,2023/12/12 8:12,2154,328,27,2509,40,三毛
因此，我虽不是同性恋者，却能够理解同性恋。爱恋，既是借助肉身而冲破肉身，性别就不是绝对的前提，既是心魂与心魂的相遇，则要紧的是他者。史铁生《病隙碎笔》  ,2023/12/11 23:41,4510,498,42,5050,77,史铁生
我想此后只要以工作赚得生活费，不受意外的气，又有点自己玩玩的余暇，就可以算是幸福了。鲁迅  ,2023/12/11 19:42,2711,500,33,3244,46,鲁迅
凡事都有偶然的凑巧，结果却又如宿命的必然。沈从文《边城》  ,2023/12/11 17:59,1480,203,7,1690,30,沈从文
人活一世，生老病死，苦难够多的了，在能享受时凭什么不享受？享受实在是人生的天经地义。周国平《当你学会独处》  ,2023/12/11 15:02,606,89,5,700,55,周国平
只是一想到你，世界在明亮的光晕里倒退一些我们以为永恒的，包括时间都不堪一击余秀华《今夜，我特别想你 》  ,2023/12/11 8:22,1549,267,3,1819,53,余秀华
每个人的童年都有一个严肃的结尾，大约都是突然面对了一个严峻的事实，再不能睡一宿觉就把它忘掉，事后你发现，童年不复存在了。史铁生  ,2023/12/10 23:09,3116,470,44,3630,65,史铁生
让自己在做事上有实力，在做人上有定力。周国平  ,2023/12/10 18:53,532,87,5,624,24,周国平
我不高兴，是指精神的我，我发烧了，是指肉身的我，我想自杀，是指精神的我要杀死肉身的我。史铁生《病隙碎笔》  ,2023/12/10 13:35,16009,1308,61,17378,54,史铁生
我们中国人好像并不习惯于纯粹的玩乐，以及以游戏和快乐为目的的运动和享受。我们的心总是被现实的压力挤压着，很容易把玩乐当成浪费，把运动当成健身，凡事似乎都为了一个目的，使正当的享受亦产生心理上的愧疚感。郭红《长岛小记·四二享受人生的时候不要感到内疚》  ,2023/12/10 10:25,2145,431,32,2608,126,郭红
“阳光好的时候，会感觉还可以活很久，甚至可以活出喜悦。”余秀华  ,2023/12/10 8:39,32072,2828,176,35076,33,余秀华
当初发明阳台的人，一定是一位乐观外向的天才，才会突破家居的局限，把一个幻想的半岛推向户外，向山和海，向半空晚霞和一夜星斗。 余光中《花鸟 》  ,2023/12/9 22:29,1832,197,17,2046,72,余光中
爱是一场远方独自的焚烧，是用灰烬重塑的自我。是疼到毁灭之时的一声喊叫，是喊叫之后永恒的沉寂。余秀华《辨认》  ,2023/12/9 19:22,1476,215,2,1693,55,余秀华
差不多每年的十二月下旬到一月中旬总会是冬天里最难熬的日子，无可躲避。再往后，随着白昼的变长，气温总会渐渐缓过来。一切总会过去的。是的，“一切总会过去”。人之所以能够感到“幸福”，不是因为生活得舒适，而是因为生活得有希望。李娟  ,2023/12/9 7:21,768,135,8,911,114,李娟
他妈的，要是这路上的九十分钟省下来和你待在一起多好。王小波《爱你就像爱生命》  ,2023/12/8 17:42,9287,824,138,10249,40,王小波
我在情感上的愚钝就像是门窗紧闭的屋子，虽然爱情的脚步在屋前走过来又走过去，我也听到了，可是我觉得那是路过的脚步，那是走向别人的脚步，直到有一天，这个脚步停留在这里，然后门铃响了。 余华《第七天》  ,2023/12/8 15:41,727,97,16,840,99,余华
我看着那些山，一层一层的，就像一个一个梯级，我觉得有一天我的灵魂踩着这些梯子会去到天上。 阿来《大地的阶梯》  ,2023/12/8 9:31,945,124,7,1076,56,阿来
当我小的时候我什么都爱。当我长大了，我忘记了我其实什么都爱。  李娟《遥远的向日葵地》  ,2023/12/7 19:42,2327,266,9,2602,45,李娟
人有四不说，不说自己目标，不说自己钱财，不说自己家事，不说自己错事，守住这四个秘密，免灾祸，远是非。莫言  ,2023/12/7 17:49,1914,321,26,2261,54,莫言
你从不曾爱过我，你只爱我在你的生命中坠落。李娟  ,2023/12/7 15:00,2529,346,22,2897,25,李娟
这一次，我真的挣脱了，自由地爱你可是我依然不敢靠近你你看，我多爱惜自己：我怕一靠近我就是灰烬余秀华《我们爱过又忘记》  ,2023/12/7 8:32,1231,169,13,1413,60,余秀华
要自杀的人，也会怕大海的汪洋，怕夏天死尸的易烂。但遇到澄静的清池，凉爽的秋夜，他往往也自杀了。鲁迅《小杂感》  ,2023/12/6 23:27,7113,782,43,7938,56,鲁迅
倘若你的眼睛真是这样冷，在你鉴照下，有个人的心会结成冰。沈从文《月下》  ,2023/12/6 21:00,4015,656,25,4696,37,沈从文
那时雨季刚过，云从四面八方升起来。天顶上闪过一缕缕阳光。我们有各种选择，可以到各方向去。所以我在路口上站了很久。王小波《黄金时代 》  ,2023/12/6 19:09,1873,330,15,2218,68,王小波
"我养育你，并非恩情，
只是血缘使然的生物本能；
所以，我既然无恩于你，你便无需报答我。
反而，我要感谢你，
因为有你的参与，
我的生命才更完整。

我只是碰巧成为了你的父亲，
你只是碰巧成为了我的女儿和儿子，
我并不是你的前传，
你也不是我的续篇。

你是独立的个体，
是与我不同的灵魂；
你并不因我而来，
你是因对生命的渴望而来。
你是自由的，
我是爱你的；
但我绝不会“以爱之名”，去掌控你的人生。
胡适写给儿子的信",2023/12/6 13:33,646,113,18,777,210,胡适
“无论怎说吧，过去的一切都不可移动；实在，所以可靠；明天的渺茫全仗昨天的实在撑持着，新梦是旧事的拆洗缝补。”老舍《老舍自传》  ,2023/12/6 8:35,675,123,4,802,64,老舍
我从来不指望自己能够吸引别人，我觉得这样很浅薄，我得吸引我自己，让我自己有了热爱，才能完成以后孤单又漫长的日子。余秀华  ,2023/12/5 19:58,3941,527,20,4488,61,余秀华
一个人身上是层层叠叠的死亡和重生。余秀华《摇摇晃晃的人间》  ,2023/12/5 9:11,4858,732,21,5611,31,余秀华
真正厉害的人，从来不说难听的话。  莫言  ,2023/12/5 8:11,2305,167,50,2522,22,莫言
“你千万别糊涂，死人都还想活过来，你一个大活人可不能去死。”  余华《活着》  ,2023/12/4 22:40,12068,533,134,12735,40,余华
你问人问题，她若答非所问，便已是答了，毋需再问。木心  ,2023/12/4 12:12,2670,314,34,3018,28,木心
经历了这么多灰心丧气的日子，麻雀还在飞，我还在搬弄旧书，玫瑰还有蕾。余秀华  ,2023/12/4 9:20,3480,412,25,3917,39,余秀华
我有感情必须发泄，有爱憎必须倾吐，否则我这颗年轻的心就会枯死。巴金  ,2023/12/4 7:55,8171,1395,63,9629,35,巴金
我心涌悲伤的时候，大口吃饭。这种炫耀，唯有风知道。余秀华《月光落在左手上》  ,2023/12/3 22:12,2373,262,22,2657,39,余秀华
真正的信心前面，其实是一片空旷，除了希望什么也没有，想要也没有。史铁生《病隙碎笔》  ,2023/12/3 18:32,1190,151,6,1347,43,史铁生
“可他说的话就像一把钝刀子在割我的脖子 脑袋掉不下来 倒是疼的死去活来”余华《活着》  ,2023/12/3 13:35,4721,427,9,5157,44,余华
按本色做人，按角色办事。 曾国藩  ,2023/12/3 10:39,858,166,16,1040,18,曾国藩
“浪漫就是浪费时间慢慢喝茶。当你浪费时间慢慢散步，浪费时间慢慢吃饭，就会自然生长出浪漫。”林清玄 《不如吃茶去》  ,2023/12/3 7:39,1845,202,14,2061,58,林清玄
一个人的悲哀之处在于，她在追寻爱情的时候依旧保持着对爱情的警惕，爱情的欢愉无法超过她对爱情本身的怀疑。余秀华  ,2023/12/2 20:20,7305,886,138,8329,56,余秀华
我突然发现了逃跑的意义，它使惩罚变得遥远，同时又延伸了快乐。余华《在细雨中呼喊》  ,2023/12/2 16:33,9378,922,64,10364,42,余华
冬天伴着火炉和书，一遍遍坚定不死的决心，写一些并不发出的信。史铁生《我与地坛 》  ,2023/12/2 8:36,3694,403,26,4123,42,史铁生
人生许多难以抉择的事情，就交给自己的内心去做决定，如果内心纯静就会告诉你正确的方向。                                                 朱德庸  ,2023/12/1 15:21,482,78,9,569,96,朱德庸
能让别人快乐的人，一定很善良。能让自己快乐的人，一定很聪明。莫言  ,2023/12/1 9:36,4922,490,67,5479,34,莫言
“永远快乐”这句话，不但渺茫得不能实现，并且荒谬得不能成立。钱钟书《论快乐》  ,2023/11/30 21:44,1393,299,14,1706,40,钱钟书
一定要爱着点什么，恰似草木对光阴的钟情。汪曾祺《人间草木》  ,2023/11/30 17:58,2289,331,25,2645,31,汪曾祺
一个人什么病都可医，惟有悲观病不可医，悲观是腐蚀人心的最大毒菌。 梁启超  ,2023/11/30 11:37,1238,180,11,1429,38,梁启超
在所有的人生模式中，为了未来而牺牲现在是最坏的一种，它把幸福永远向后推延，实际上是取消了幸福。 周国平  ,2023/11/30 9:37,2156,614,39,2809,53,周国平
早晨不起，误一天的事，幼时不学，误一生的事。自律的人，往往有着极大的自控力，而能控制自我的人，方能控制人生。曾国藩  ,2023/11/30 7:16,1031,145,20,1196,59,曾国藩
“对春花、秋月、夏雨、冬雪，对友谊，对人间一切美好的事情，我仍然是非动真感情不行的。对我来说，这是一件天大的好事。”季羡林  ,2023/11/29 20:12,1730,269,14,2013,63,季羡林
记得沈从文这样说过:“凡是美的都没有家，流星，落花，萤火，最会鸣叫的蓝头红嘴绿翅膀的王母鸟，也都没有家的。谁见过人蓄养凤凰呢？谁能束缚着月光呢？一颗流星自有它来去的方向，我有我的去处。”灵魂是一面随风招展的旗子，人永远不要忽视身边事物，因为它也许正可以飘动你心中的那面旗，即使是小如松子。林清玄《松子茶》,2023/11/29 13:49,1093,262,19,1374,152,林清玄
后来，你会发现你不仅要自己做选择，而且还要敢于承担后果。刘同《我在未来等你》  ,2023/11/29 8:02,974,95,12,1081,40,刘同
大学生大都爱吃，食欲很旺，有两个钱都吃掉了。汪曾祺  ,2023/11/28 23:39,17659,2110,478,20247,27,汪曾祺
无聊是对欲望的欲望，我的孤独认识你的孤独。汪曾祺  ,2023/11/28 23:16,839,126,3,968,26,汪曾祺
进退维谷之日正可能是别有洞天之时，这差不多能算规律。史铁生《病隙碎笔》  ,2023/11/28 18:57,1629,339,28,1996,37,史铁生
你须把受委屈当作生活，而从委屈中咂摸出一点甜味来，好使你还肯活下去老舍《四世同堂》  ,2023/11/28 15:23,610,67,10,687,43,老舍
我试图立足于有限的时间里，来用文字笼络住无穷的空间。陈春成《夜晚的潜水艇》  ,2023/11/28 11:39,793,115,8,916,39,陈春成
“这个世界上也有人不了解海，不知爱海。也有人了解海，不敢爱海。”沈从文《八骏图》  ,2023/11/28 7:56,2010,207,27,2244,42,沈从文
处世不必邀功，无过便是功；与人不求感德，无怨便是德。洪应明《菜根谭》  ,2023/11/27 21:32,1037,234,4,1275,36,洪应明
凡是美的都没有家，流星，落花，萤火，最会鸣叫的蓝头红嘴绿翅膀的王母鸟，也都没有家的。沈从文  ,2023/11/27 10:50,2174,487,31,2692,47,沈从文
差不多每年的十二月下旬到一月中旬总会是冬天里最难熬的日子，无可躲避。再往后，随着白昼的变长，气温总会渐渐缓过来。一切总会过去的。是的，“一切总会过去”。人之所以能够感到“幸福”，不是因为生活得舒适，而是因为生活得有希望。李娟  ,2023/11/26 19:36,828,207,13,1048,114,李娟
我是爱你的，看见就爱上了。我爱你爱到不自私的地步。就像一个人手里一只鸽子飞走了，他从心里祝福那鸽子的飞翔，你也飞吧。我会难过，也会高兴，到底会怎么样， 我也不知道。王小波《爱你就像爱生命》  ,2023/11/26 15:59,2209,467,39,2715,96,王小波
“我知道宇宙和永恒是无限的，而我自己和一切人一样都是有限的。我非常非常不喜欢这个对比，老想把它否定掉。于是我开始去思索是否有一种比人和人类都更伟大的意义。想明白了从人的角度看来这种意义是不存在的以后，我面前就出现了一片寂寞的大海。人们所做的一切不过是些死前的游戏……”  王小波《绿毛水怪》,2023/11/26 13:07,668,166,3,837,145,王小波
“吃苦必须有收益，牺牲必须有代价。有些人认为，人必须吃一些无意义的苦、虚掷一些年华，用这种方法来达到崇高。这种想法不仅有害，而且是有病的。” 王小波《沉默的大多数》  ,2023/11/26 8:10,1323,290,11,1624,84,王小波
你绝对温存，绝对可爱，生机勃勃，全无畏惧而且自信。我从你身上感到一种永存的精神，超过平庸生活里的一切。王小波 《地久天长》  ,2023/11/25 18:29,4921,952,39,5912,63,王小波
“你自己爱干啥就干啥，首先要当个正直的人，其次要当个快乐的人。 不要过于纠结是否独自一人，努力去寻求快乐就足够了。” 王小波《黄金时代》  ,2023/11/25 13:12,2518,402,22,2942,70,王小波
“将来的我比现在好，这一点我已经有了把握。”王小波  ,2023/11/25 8:26,4464,499,35,4998,27,王小波
“如果养马只是为了吃肉，生活还索然无味到什么地步？”李娟《我的阿勒泰》  ,2023/11/24 16:42,692,102,7,801,37,李娟
人间万千光景，苦乐喜忧，跌撞起伏，除了自渡，他人爱莫能助。季羡林《悲喜自渡》  ,2023/11/24 8:19,1167,198,9,1374,40,季羡林
在科学的迷茫之处，在命运的混沌之点，人惟有乞灵于自己的精神。不管我们信仰什么，都是我们自己的精神的描述和引导。史铁生《我二十一岁那年》  ,2023/11/23 23:44,1001,145,10,1156,69,史铁生
如果我写不出温柔漂亮的句子，你能不能直接看一看我温柔的心。冯唐 《无所畏》  ,2023/11/23 20:33,3960,708,35,4703,39,冯唐
“你要爱就要像一个痴情的恋人那样去爱，像一个忘死的梦者那样去爱，视他人之疑目如盏盏鬼火，大胆去走你的夜路。”史铁生《病隙碎笔》  ,2023/11/23 16:05,4683,625,25,5333,65,史铁生
他知道，空冥的猜想可以负载任意的梦景，而实在的答案便会限定出真确的痛苦。史铁生《务虚笔记》  ,2023/11/23 12:46,1096,161,5,1262,47,史铁生
中国的孩子，只要生，不管他好不好，只要多，不管他才不才。生他的人，不负教他的责任。虽然“人口众多”这一句话，很可以闭了眼睛自负，然而这许多人口，便只在尘土中辗转，小的时候，不把他当人，大了以后，也做不了人。    鲁迅《随感录二十五》  ,2023/11/22 23:50,2924,424,70,3418,119,鲁迅
说老实话，我觉得与其骂人，宁可挨骂。因为骂人是自我表演，挨骂是看人家有意识或无意识的表演——表演他们对我的心意，而无意中流露的真情，往往是很耐人寻味的。杨绛 《将饮茶》  ,2023/11/22 8:03,974,140,25,1139,86,杨绛
人与人的交往多半肤浅，或只有在较为肤浅的层面上，交往才是容易的，一旦走进深处，人与人就是相互的迷宫。史铁生  ,2023/11/21 22:41,2361,349,17,2727,55,史铁生
“一辈子都在省着，攒着，不论多抠，钱还是没存够。一辈子都在忍着，让着，怕着，不论多小心，人还是得罪的不少。一辈子都在读着，写着，悟着，不论多聪明，亏还是没少吃。一辈子都在觉醒中，成熟中，成长中，不论多淡定，遗憾还是有。回头看，除了苍老的容颜，渐长的年龄，满腹的心酸，还有什么真正属于自己？所以想开了，什么才是生活，只有自己高兴了，那才是生活。”三毛,2023/11/21 8:00,1393,295,16,1704,174,三毛
我将向黑暗里彷徨于无地。你还想我的赠品。我能献你甚么呢？无已，则仍是黑暗和虚空而已。鲁迅《影的告别》  ,2023/11/20 22:02,653,84,6,743,52,鲁迅
譬如游山，走过了一段路之后，乘喘息未定的时候，回望来路，白云四合，当然很有意思的。倘再翘首前路，更有青霭流泛，不也增加游兴不少吗？季羡林《悲喜自渡》  ,2023/11/20 16:43,546,83,2,631,76,季羡林
我说出的每一句话，到头来都封住了我的本意。李娟《阿勒泰的角落》  ,2023/11/20 8:12,5208,575,40,5823,33,李娟
现在的社会，分不清理想与妄想的区别。再过几时，还要分不清“做不到”与“不肯做到”的区别，要将扫除庭园与劈开地球混作一谈。鲁迅《热风.随感录三十九》  ,2023/11/19 21:12,887,202,6,1095,75,鲁迅
“人一灰心便只能看到别人的错处，而不看自己的消沉堕落！” 老舍《四世同堂》  ,2023/11/19 12:47,697,103,1,801,39,老舍
如果不想得癌，少得癌，特别是女生，像乳腺癌、卵巢癌、宫颈癌啊，就一定要放开，就是要混蛋一点，内心要强大到混蛋，你得癌的机会就会少一些。冯唐  ,2023/11/19 1:04,6195,495,76,6766,71,冯唐
人的身体可以被囚禁，人的心却不可以。巴金《家》  ,2023/11/18 21:56,884,90,5,979,25,巴金
当生命以美的形式证明其价值的时候，幸福是享受，痛苦也是享受。史铁生 《好运设计》  ,2023/11/17 18:43,1298,235,7,1540,42,史铁生
当你满腹心事，渴望找人倾诉时，你会突然发现，有些人不想找，有些人不能找，还有些人你想找却不敢打扰。杨绛  ,2023/11/17 8:32,1849,239,27,2115,53,杨绛
我独处时最轻松，因为我不觉得自己乏味，即使乏味，也自己承受，不累及他人，无需感到不安。周国平  ,2023/11/16 16:29,2111,357,21,2489,48,周国平
世上的事常常使上帝的居心变得可疑。史铁生 《我与地坛》  ,2023/11/16 15:10,1522,109,10,1641,29,史铁生
人如果放弃了主动对自己的塑造，就只能被世界所塑造，被时代和环境所塑造，被他人所塑造。通常，这就被称之为：随波逐流。 半山《半山文集》  ,2023/11/16 9:17,2361,419,18,2798,68,半山
全世界都爱我，没有用，自己恨自己。邱妙津《鳄鱼手记》  ,2023/11/15 11:39,6089,791,59,6939,28,邱妙津
经历了这么多灰心丧气的日子，麻雀还在飞，我还在搬弄旧书，玫瑰还有蕾。余秀华  ,2023/11/15 9:15,6863,808,32,7703,39,余秀华
人不该太清醒，过去的事情就让它过去，不必反复咀嚼。一生不长，重要的事儿也没那么多。天亮了，又赚了。冯唐《春风十里不如你》  ,2023/11/14 21:19,1748,268,19,2035,62,冯唐
我们心中的许多主义，许多相聚的黄昏不过是把已经模糊的爱恋清晰给自已看余秀华《我们爱过又忘记 》  ,2023/11/14 18:00,1808,200,11,2019,49,余秀华
这样的日子，早死一天是一天的福气。莫言《粮食》  ,2023/11/14 11:07,5923,1065,89,7077,25,莫言
你喜欢黑咖啡，我熬得特别浓。白先勇《纽约客》  ,2023/11/13 18:43,1286,136,18,1440,24,白先勇
